Agulhas	Agulhas
L'Agulhas Links Golf Estate	Agulhas
Albertinia	Albertinia
Theronville	Albertinia
Arniston	Arniston
Ashton	Ashton
Zolani	Ashton
Athlone	Athlone
Belgravia	Athlone
Bonteheuwel	Athlone
Bridgetown	Athlone
Forbes	Athlone
Gatesville	Athlone
Gleemoor	Athlone
Hanover Park	Athlone
Hatton	Athlone
Hazendal	Athlone
Heideveld	Athlone
Kewtown	Athlone
Lincoln	Athlone
Lochiel	Athlone
Manenberg	Athlone
Mountview	Athlone
Newfields	Athlone
Primrose Park	Athlone
Rustdale	Athlone
Rylands	Athlone
Sand Industria	Athlone
Silvertown	Athlone
Sunnyside	Athlone
Surrey	Athlone
Sybrandpark	Athlone
Vanguard	Athlone
Welcome	Athlone
Zwartdam	Athlone
Atlantis Industrial	Atlantis
Avondale	Atlantis
Beaconhill	Atlantis
Protea Park	Atlantis
Robinvale	Atlantis
Saxonsea	Atlantis
Saxonwood	Atlantis
Sherwood	Atlantis
Wesfleur	Atlantis
Witsand	Atlantis
Aurora	Aurora
Barrydale	Barrydale
Beaufort West	Beaufort West
Beaufort West Central	Beaufort West
Beaufort West Industrial Park	Beaufort West
Die Laning	Beaufort West
Essopville	Beaufort West
Hillside	Beaufort West
Hillside 2	Beaufort West
Hillside 3	Beaufort West
Hooyvlakte	Beaufort West
Hospital Hill	Beaufort West
Kwa-Mandlenkosi	Beaufort West
New Town	Beaufort West
Newlands	Beaufort West
Nieuveld Park	Beaufort West
North End	Beaufort West
Prince Valley	Beaufort West
Rustdene	Beaufort West
Spoorwegkamp	Beaufort West
Toekomsrus	Beaufort West
Belhar	Belhar
Belhar 1	Belhar
Belhar 10	Belhar
Belhar 11	Belhar
Belhar 12	Belhar
Belhar 13	Belhar
Belhar 14	Belhar
Belhar 15	Belhar
Belhar 16	Belhar
Belhar 17	Belhar
Belhar 18	Belhar
Belhar 19	Belhar
Belhar 2	Belhar
Belhar 20	Belhar
Belhar 21	Belhar
Belhar 23	Belhar
Belhar 3	Belhar
Belhar 4	Belhar
Belhar 5	Belhar
Belhar 6	Belhar
Belhar 7	Belhar
Belhar 8	Belhar
Belhar 9	Belhar
Erica Township	Belhar
Alf. Blv	Bellville
Amanda Glen	Bellville
Avondstil	Bellville
Belair	Bellville
Belgravia	Bellville
Bellair	Bellville
Bellville	Bellville
Bellville Central	Bellville
Bellville Lot 1	Bellville
Bellville Lot 2	Bellville
Bellville Lot 3	Bellville
Bellville Lot 5	Bellville
Bellville Lot 6	Bellville
Bellville Park	Bellville
Bellville South	Bellville
Bellville South Ext 13	Bellville
Bellville South Ext 14	Bellville
Bellville South Industrial	Bellville
Bellville West A	Bellville
Belrail	Bellville
Bethanie	Bellville
Blanc Kelly	Bellville
Bloemhof	Bellville
Blommendal	Bellville
Blomtuin	Bellville
Blomvlei	Bellville
Bo Oakdale	Bellville
Bosbell	Bellville
Boston	Bellville
Boston Farm	Bellville
Brick A Clay Blv	Bellville
Chantecler	Bellville
Chianti Villas	Bellville
Chrismar	Bellville
Danena	Bellville
De Bron	Bellville
De La Haye	Bellville
De Uitkijk Estate	Bellville
Door De Kraal	Bellville
Dunrobin	Bellville
East Rock	Bellville
Eskom	Bellville
Eversdal	Bellville
Glen Ive	Bellville
Glenhaven	Bellville
Grahamdale	Bellville
Greenlands	Bellville
Groenvallei	Bellville
Harry De Villiers	Bellville
Heemstede	Bellville
Hillrise	Bellville
Hoheizen	Bellville
Horstmandale	Bellville
Hume	Bellville
Joostenville	Bellville
Joubertsingel	Bellville
Kanonberg Lifestyle Estate	Bellville
Kempenville	Bellville
Kenridge	Bellville
Kingston	Bellville
La Rochelle	Bellville
La Veritas Estate	Bellville
Labiance	Bellville
Laurindale	Bellville
Lingen	Bellville
Loevenstein	Bellville
Loumar	Bellville
Louwville	Bellville
Maniesoord	Bellville
Meyerhof	Bellville
Nieuw Maastrecht	Bellville
Oakdale	Bellville
Oakglen	Bellville
Octovale	Bellville
O'Kennedyville	Bellville
Oude Westhof	Bellville
Pascall	Bellville
Peninsula Technikon	Bellville
Pieke & Marionstat	Bellville
Protea Valley	Bellville
Ridgeworth	Bellville
Rosendal	Bellville
Rosenpark	Bellville
Sacks Circle Industrial	Bellville
Sanlamhof	Bellville
Saxon Industrial	Bellville
Selborne	Bellville
Shirley Park	Bellville
Silverstream	Bellville
Sirrocco's	Bellville
Sonstraal	Bellville
Sportgronde & Westclif Middelbar	Bellville
Stanlou	Bellville
Stellenberg	Bellville
Stellenridge	Bellville
Stellenryk	Bellville
Stikland	Bellville
Stikland Hospital	Bellville
Stikland Industrial	Bellville
Sunkist	Bellville
Transnet Marshalling Yard	Bellville
Triangle Farm	Bellville
Tyger Valley	Bellville
Unclear	Bellville
University of the Western Cape	Bellville
Van Riebeeckshof	Bellville
Vosfontein	Bellville
Vredelust	Bellville
Vredenberg	Bellville
Welgedacht Country Estate	Bellville
Welgemoed	Bellville
Welgemoed Greens	Bellville
De Hoek Mine	Bergrivier Rural
Goedverwacht	Bergrivier Rural
Wittewater	Bergrivier Rural
Betty's Bay	Betty's Bay
Klipkop	Betty's Bay
Sunny Seas Estates	Betty's Bay
Birkenhead	Birkenhead
Romansbaai Beach and Fynbos Estate	Birkenhead
Bitterfontein	Bitterfontein
Blackheath Industrial	Blackheath
Dennemere	Blackheath
Gaylee	Blackheath
Happy Valley	Blackheath
Rustdal	Blackheath
Saxenburg Park 1	Blackheath
Saxenburg Park 2	Blackheath
Big Bay	Blouberg
Blouberg Hills Estate	Blouberg
Blouberg Rise	Blouberg
Blouberg Sands	Blouberg
Bloubergrant	Blouberg
Bloubergstrand	Blouberg
Dune Ridge Estate	Blouberg
Sandown Estate	Blouberg
West Beach	Blouberg
Austinville	Blue Downs
Bardale Village	Blue Downs
Blue Downs	Blue Downs
Brentwood Park	Blue Downs
Camelot	Blue Downs
Delro Village	Blue Downs
Diepwater (Wesbank)	Blue Downs
Drift Sands	Blue Downs
Electric City	Blue Downs
Fairdale	Blue Downs
Forest Glade	Blue Downs
Forest Heights	Blue Downs
Forest Village	Blue Downs
Fountain Village	Blue Downs
Greenfields	Blue Downs
Hagley	Blue Downs
Highgate	Blue Downs
Hill View	Blue Downs
Hillcrest Heights	Blue Downs
Hindle Park	Blue Downs
Kleinvlei	Blue Downs
Malibu Village	Blue Downs
Mfuleni	Blue Downs
Oxford Village	Blue Downs
Palm Park	Blue Downs
Park Village	Blue Downs
Perm Gardens	Blue Downs
Pine Place	Blue Downs
Rosedale	Blue Downs
Rotterdam	Blue Downs
Silversands	Blue Downs
Stellenrust	Blue Downs
Sunbird Park	Blue Downs
Sunset Glen	Blue Downs
The Conifers	Blue Downs
Tuscany Glen	Blue Downs
Vogelvlei (Wesbank)	Blue Downs
Wembley Park	Blue Downs
Wimbledon Estate	Blue Downs
Boggoms Bay	Boggoms Bay
Bonnievale	Bonnievale
Happy Valley	Bonnievale
Mountain View	Bonnievale
Bot River	Bot River
Arauna	Brackenfell
Botfontein Smallholdings	Brackenfell
Bracken Heights	Brackenfell
Brackenfell Central	Brackenfell
Brackenfell Industrial	Brackenfell
Brackenfell North	Brackenfell
Brackenfell South	Brackenfell
Brackengate Business Park	Brackenfell
Burgundy	Brackenfell
Cape Gate	Brackenfell
Chamonix	Brackenfell
De Oude Spruit	Brackenfell
De Tuin	Brackenfell
Edenpark	Brackenfell
Everite Industrial	Brackenfell
Ferndale	Brackenfell
Hoogstede	Brackenfell
Kaapsig	Brackenfell
Klaradyn Retirement Village	Brackenfell
Kleinbron Estate	Brackenfell
Kleinbron Park	Brackenfell
Marlborough Park	Brackenfell
Morgen Industrial	Brackenfell
Morgenster	Brackenfell
Morgenster Hoogte	Brackenfell
Normandie Estate	Brackenfell
Northpine	Brackenfell
Okavango Park	Brackenfell
Protea Heights	Brackenfell
Protea Village	Brackenfell
Ruwari	Brackenfell
Sauvignon	Brackenfell
Sole` Country Estate	Brackenfell
Sonkring	Brackenfell
Springbokpark	Brackenfell
St Kilda	Brackenfell
St Michaels	Brackenfell
Vredekloof	Brackenfell
Vredekloof East	Brackenfell
Vredekloof Glen	Brackenfell
Vredekloof Heights	Brackenfell
Vredekloof Rand	Brackenfell
Welgelee	Brackenfell
Brandwacht	Brandwacht
Bredasdorp	Bredasdorp
Bredasdorp Industrial	Bredasdorp
Kleinbegin	Bredasdorp
Selfbou	Bredasdorp
Brenton	Brenton
Lake Brenton	Brenton
Brenton-on-Sea	Brenton-on-Sea
Buffeljagsrivier	Buffeljagsrivier
Buffels Bay	Buffels Bay
Bergsig	Caledon
Caledon	Caledon
Myddleton	Caledon
Tjotjombeni	Caledon
Uitsig	Caledon
Bergsig	Calitzdorp
Calitzdorp	Calitzdorp
Elim	Cape Agulhas Rural
Skihaven Township	Cape Agulhas Rural
Cape of Good Hope Nature Reserve	Cape Point
Castle Rock	Cape Point
Redhill	Cape Point
Smitswinkel Bay	Cape Point
Bakoven	Cape Town
Bantry Bay	Cape Town
Belthorn Estate	Cape Town
Bergvliet	Cape Town
Bishopscourt	Cape Town
Brooklyn	Cape Town
Buckingham	Cape Town
Cafda Village	Cape Town
Camps Bay	Cape Town
Cape Town City Centre	Cape Town
Claremont	Cape Town
Clifton	Cape Town
Coniston Park	Cape Town
Crawford	Cape Town
De Waterkant	Cape Town
Dennendal	Cape Town
Devil's Peak Estate	Cape Town
Diep River	Cape Town
Dreyersdal	Cape Town
Eden Klein	Cape Town
Edward	Cape Town
Elfindale	Cape Town
Fairways	Cape Town
Ferness	Cape Town
Foreshore	Cape Town
Forest Glade	Cape Town
Frere Estate	Cape Town
Fresnaye	Cape Town
Gardens	Cape Town
Glen Valley	Cape Town
Glen View	Cape Town
Green Point	Cape Town
Heathfield	Cape Town
Kenilworth	Cape Town
Kensington	Cape Town
Kirstenhof	Cape Town
Lagoon Beach	Cape Town
Lansdowne	Cape Town
Lavender Hill	Cape Town
Maitland	Cape Town
Maitland Garden Village	Cape Town
Meadowridge	Cape Town
Metro Industrial Township	Cape Town
Mouille Point	Cape Town
Mowbray	Cape Town
Ndabeni	Cape Town
Nerissa Estate	Cape Town
Newlands	Cape Town
Observatory	Cape Town
Oranjezicht	Cape Town
Ottery	Cape Town
Ottery East	Cape Town
Otyhouse Estate	Cape Town
Oude Molen Village	Cape Town
Paarden Eiland	Cape Town
Penlyn Estate	Cape Town
Pinati	Cape Town
Pinelands	Cape Town
Plumstead	Cape Town
Pollsmoor	Cape Town
Retreat	Cape Town
Rogge Bay	Cape Town
Romp Vallei	Cape Town
Romp Vlei	Cape Town
Rondebosch	Cape Town
Rondebosch East	Cape Town
Rosebank	Cape Town
Royal Cape	Cape Town
Rugby	Cape Town
Salt River	Cape Town
Schotschekloof	Cape Town
Sea Point	Cape Town
Seawinds	Cape Town
Sheraton Park	Cape Town
Silvertree Estate	Cape Town
Silwersteen Estate	Cape Town
Southfield	Cape Town
Steenberg	Cape Town
Steenberg Golf Estate	Cape Town
Sunlands	Cape Town
Tamboerskloof	Cape Town
Three Anchor Bay	Cape Town
Tokai	Cape Town
Turf Hall	Cape Town
Turf Hall Estate	Cape Town
University Estate	Cape Town
V & A Waterfront	Cape Town
Vredehoek	Cape Town
Walmer Estate	Cape Town
Westlake	Cape Town
Wetton	Cape Town
Windermere	Cape Town
Woodstock	Cape Town
Wynberg	Cape Town
Yorkshire Estate	Cape Town
Youngsfield	Cape Town
Ysterplaat Airbase	Cape Town
Zonnebloem	Cape Town
Beeskamp	Ceres
Bella Vista	Ceres
Ceres	Ceres
Ceres Golf and Country Estate	Ceres
Egoli	Ceres
Nduli	Ceres
Rooikamp	Ceres
White City	Ceres
Citrusdal	Citrusdal
Oranjeville	Citrusdal
Atlantic Hills	City of Cape Town Rural
East-Rural	City of Cape Town Rural
Fisantekraal	City of Cape Town Rural
Fisantekraal Industrial	City of Cape Town Rural
Greenville Garden City	City of Cape Town Rural
Kleine Zout Rivier AH	City of Cape Town Rural
Klipheuwel	City of Cape Town Rural
Malmesbury Farms	City of Cape Town Rural
Meerendal AH	City of Cape Town Rural
Morning Star AH	City of Cape Town Rural
Oudekraal (Nature Reserve)	City of Cape Town Rural
Paarl Farms	City of Cape Town Rural
Pella-Katzenberg	City of Cape Town Rural
Signal Hill	City of Cape Town Rural
Silver Mine (Nature Reserve)	City of Cape Town Rural
Table Mountain (Nature Reserve)	City of Cape Town Rural
Tygerberg (Nature Reserve)	City of Cape Town Rural
Wedderwill	City of Cape Town Rural
Clanwilliam	Clanwilliam
Crystal Waters	Clanwilliam
Hopland	Clanwilliam
Airlie	Constantia
Alphen	Constantia
Barbarossa	Constantia
Bel Ombre	Constantia
Belle Constantia	Constantia
Constantia	Constantia
Constantia Heights	Constantia
Constantia Vale	Constantia
Constantia Village	Constantia
Deurdrif	Constantia
Eagles Nest	Constantia
Fir Grove	Constantia
Firgrove	Constantia
Glen Alpine	Constantia
Graylands	Constantia
High Constantia	Constantia
Hope of Constantia	Constantia
Huis-In-Bos	Constantia
Nova Constantia	Constantia
Pagasvlei	Constantia
Porter Reform Estate	Constantia
Rust-En-Vrede	Constantia
Sillery	Constantia
Sillery Private Estate	Constantia
Silverhurst	Constantia
Silverhurst Estate	Constantia
Strawberry Fields	Constantia
Sweet Valley	Constantia
The Vines	Constantia
Uitsig Estate	Constantia
Witteboomen	Constantia
Darling	Darling
Nuwedorp	Darling
De Doorns	De Doorns
De Doorns East	De Doorns
Mountain View	De Doorns
De Kelders	De Kelders
De Rust	De Rust
Delft	Delft
Delft South	Delft
Eindhoven	Delft
Leiden	Delft
Roosendal	Delft
The Hague	Delft
Voorbrug	Delft
Die Dorp Op Die Berg	Die Dorp Op Die Berg
Doringbaai	Doringbaai
Bain's Kloof Pass	Drakenstein Rural
Hermon	Drakenstein Rural
La Bella Vita Estate	Drakenstein Rural
Pearl Valley Golf Estate and Spa	Drakenstein Rural
Uitgezocht Estate	Drakenstein Rural
Val De Vie Winelands Lifestyle Estate	Drakenstein Rural
Winelands Estate	Drakenstein Rural
Albury Place	Durbanville
Altydgedacht	Durbanville
Amanda Glen	Durbanville
Aurora	Durbanville
Avalon Estate	Durbanville
Belvedere Estate	Durbanville
Belvedere Mews	Durbanville
Berghshoop Estate	Durbanville
Bergsig	Durbanville
Bo Verwachting Estate	Durbanville
Brentwood Park	Durbanville
Clara Anna Fontein	Durbanville
De Vijgen	Durbanville
De Wingerd	Durbanville
Dorstberg Estate	Durbanville
D'urbanvale	Durbanville
Durbanville	Durbanville
Durbanville Hills	Durbanville
Durbanville Meadows	Durbanville
Durbell	Durbanville
Durmonte	Durbanville
Elishua Villas	Durbanville
Everglen	Durbanville
Everglen Manor	Durbanville
Eversdal	Durbanville
Eversdal Heights	Durbanville
Fairtrees Estate	Durbanville
Fig Tree Estate	Durbanville
Goedemoed	Durbanville
Graanendal Estate	Durbanville
Halali	Durbanville
Heerenzicht Estate	Durbanville
Hillwood Estate	Durbanville
Kenever	Durbanville
Kenridge	Durbanville
Kenridge Heights	Durbanville
Klein Nederburg	Durbanville
La Boheme Estate	Durbanville
La Verona	Durbanville
Langeberg Village	Durbanville
Longwood	Durbanville
Morningstar	Durbanville
Natures Valley	Durbanville
Nerina	Durbanville
Oakwood Estate	Durbanville
Pinehurst	Durbanville
Proteaville	Durbanville
Rochefort Village	Durbanville
Rosedale Estate	Durbanville
Ruitershoogte	Durbanville
Schoongezight	Durbanville
Sonstraal	Durbanville
Sonstraal Heights	Durbanville
Summerwood	Durbanville
Tankazicht	Durbanville
The Crest	Durbanville
Uitzicht	Durbanville
Uitzicht 1	Durbanville
Uitzicht Security Estate	Durbanville
Valmary Park	Durbanville
Vergesig	Durbanville
Verona Villas	Durbanville
Vierlanden	Durbanville
Vierlanden Heights	Durbanville
Vierlanden Kleinhoewes	Durbanville
Vygeboom	Durbanville
Vygeboord Village	Durbanville
Wairoa	Durbanville
Welgevonden Estate	Durbanville
Wellway Park	Durbanville
Wellway Park East	Durbanville
Dysseldorp	Dysseldorp
Ebenhaezer	Ebenhaezer
Eendekuil	Eendekuil
Beverly Park	Eerste River
Clairwood	Eerste River
De Wijnlanden	Eerste River
Devon Park	Eerste River
Devon Park Village	Eerste River
Eerste River	Eerste River
Eerste River Industrial	Eerste River
Gill Cape	Eerste River
Heather Park	Eerste River
High Places	Eerste River
Houghton	Eerste River
Russel's Rest	Eerste River
Sillwood Heights	Eerste River
Stratford Green	Eerste River
The Wines	Eerste River
Elands Bay	Elands Bay
Adriaanse	Elsies River
Avon	Elsies River
Avonwood	Elsies River
Balvenie	Elsies River
Clarkes Estate	Elsies River
Connaught	Elsies River
Cravenby	Elsies River
Elnor	Elsies River
Elsies River Industrial	Elsies River
Epping Forest	Elsies River
Eureka Estate	Elsies River
Leonsdale	Elsies River
Norwood	Elsies River
Riverton	Elsies River
Salberau	Elsies River
The Range	Elsies River
Valhalla	Elsies River
Capri	Fish Hoek
Clovelly	Fish Hoek
Faerie Knowe	Fish Hoek
Fish Hoek	Fish Hoek
Kalk Bay	Fish Hoek
Masiphumelele	Fish Hoek
Santorini Village	Fish Hoek
Silverglade	Fish Hoek
Stonehaven Estate	Fish Hoek
Sun Valley	Fish Hoek
Sunnydale	Fish Hoek
Fisherhaven	Fisherhaven
Fransche Hoek Estate	Franschhoek
Franschhoek	Franschhoek
L' Avenue de Franschhoek	Franschhoek
La Ferme Chantelle Wine Estate	Franschhoek
La Petite Provence	Franschhoek
Le Roux	Franschhoek
Franskraal	Franskraal
Uilenkraalsmond	Franskraal
Friemersheim	Friemersheim
Blompark	Gans Bay
Gans Bay	Gans Bay
Kolgansbaai Village	Gans Bay
Masakhane	Gans Bay
Bereaville	Genadendal
Bosmanskloof	Genadendal
Genadendal 1	Genadendal
Genadendal 2	Genadendal
Ballotsview	George
Bergsig	George
Blanco	George
Blue Mountain Village	George
Bodorp	George
Borcherds	George
Bos En Dal	George
Campher's Drift	George
Cherry Creek	George
Conville	George
Denneoord	George
Denvar Park	George
Deville Park	George
Dormehls Drift	George
Earls Court Lifestyle Estate	George
Eastern Ext	George
Eden George	George
Fancourt	George
Fernridge	George
George	George
George Central	George
George Industria	George
George South	George
Glen Barrie	George
Glenwood AH	George
Groeneweid Park	George
Heather Park	George
Heatherlands	George
King George Park	George
Kingswood Golf Estate	George
Kraaibosch Country Estate	George
Kraaibosch Manor	George
Lawaaikamp	George
Levallia	George
Loerie Park	George
Mont Fleur Mountain Estate	George
Nu Dawn	George
Oaklands At Fancourt	George
Pacaltsdorp	George
Parkdene	George
Protea Park	George
Rooirivier-Rif	George
Rosemore	George
Sea View	George
Soeteweide Country Estate	George
Tamsu Industria	George
Thembalethu	George
Twee Rivieren	George
Urban Village Security Estate	George
Welgelegen	George
Lagoon Bay Lifestyle Estate	George Rural
Le Grand	George Rural
Le Grand George Golf Estate	George Rural
Van Rooyens Rus	George Rural
Acacia Park	Goodwood
Edgemead	Goodwood
Epping Garden Village	Goodwood
Epping Industria 1	Goodwood
Epping Industria 2	Goodwood
Glenwood	Goodwood
Goodwood Estate	Goodwood
Montague	Goodwood
Monte Vista	Goodwood
N1 City	Goodwood
North Camp Wingfield	Goodwood
Plattekloof Glen	Goodwood
Richmond	Goodwood
Richmond Estate	Goodwood
Ruyterwacht	Goodwood
Thornton	Goodwood
Townsend Estate	Goodwood
Tygerdal	Goodwood
Vasco Estate	Goodwood
Viking Park	Goodwood
W P Park	Goodwood
Wingfield	Goodwood
Admirals Park	Gordons Bay
Anchorage Park	Gordons Bay
Bay Park	Gordons Bay
Cayman Beach	Gordons Bay
Dobson	Gordons Bay
Fairview Golf Estate	Gordons Bay
Gordon Heights	Gordons Bay
Gordons Bay	Gordons Bay
Gordons Bay Village	Gordons Bay
Harbour Island	Gordons Bay
La Fontana	Gordons Bay
Lost City	Gordons Bay
Mansfield	Gordons Bay
Mansfield Industrial	Gordons Bay
Mountainside	Gordons Bay
Onverwacht	Gordons Bay
Pine Acres	Gordons Bay
Protea Park	Gordons Bay
Sea Breez Park	Gordons Bay
Temperance Town	Gordons Bay
Winslow	Gordons Bay
Gouda	Gouda
Gouritz	Gouritz
Graafwater	Graafwater
Dennekruin	Grabouw
Elgin	Grabouw
Elgin Village	Grabouw
Grabouw	Grabouw
Grabouw Industrial Park	Grabouw
Nuwedorp A	Grabouw
Pineview	Grabouw
Pineview North	Grabouw
Rooidakkies	Grabouw
Snake Park	Grabouw
Swannie River	Grabouw
False Bay Coastal Park	Grassy Park
Grassy Park	Grassy Park
Lotus River	Grassy Park
Parkwood	Grassy Park
Pelikan Heights	Grassy Park
Pelikan Park	Grassy Park
Zeekoei Vlei	Grassy Park
Greyton	Greyton
Heuwelkroon	Greyton
Avonddans Country Estate	Groot Brakrivier
Bergsig	Groot Brakrivier
Bothastrand	Groot Brakrivier
Glentana	Groot Brakrivier
Greenhaven	Groot Brakrivier
Groot Brakrivier	Groot Brakrivier
Klein Brak River	Groot Brakrivier
Outeniqua Strand	Groot Brakrivier
Reebok	Groot Brakrivier
Southern Cross	Groot Brakrivier
Tergniet	Groot Brakrivier
The Island	Groot Brakrivier
Wolwedans	Groot Brakrivier
Grotto Bay	Grotto Bay
Barcelona	Guguletu
Crossroads	Guguletu
Guguletu	Guguletu
Kanana	Guguletu
KTC	Guguletu
New Rest	Guguletu
Phola Park	Guguletu
Haarlem	Haarlem
Hawston	Hawston
Heidelberg	Heidelberg
Herbertsdale	Herbertsdale
Eastcliff	Hermanus
Fernkloof Village	Hermanus
Glen Fruin	Hermanus
Hemel en Aarde Estate	Hermanus
Hermanus	Hermanus
Hermanus Heights	Hermanus
Hillside Village	Hermanus
Innesbrook Village	Hermanus
Lakewood Village	Hermanus
Mariners Village	Hermanus
Mount Pleasant	Hermanus
Prestwick Village	Hermanus
Voelklip	Hermanus
Westcliff	Hermanus
Zwelihle	Hermanus
Breakwater Bay Eco Estate	Herolds Bay
Herolds Bay	Herolds Bay
Oubaai Golf Estate	Herolds Bay
The Brink Eco Estate	Herolds Bay
Hartebeesfontein	Hopefield
Hopefield	Hopefield
Oudekraalfontein	Hopefield
Avignon Estate	Hout Bay
Baviaankloof Estate	Hout Bay
Beach Estate	Hout Bay
Berg-En-Dal	Hout Bay
Hangberg	Hout Bay
Hanging Meadows	Hout Bay
Helgarda Estate	Hout Bay
Hillcrest	Hout Bay
Hout Bay	Hout Bay
Hout Bay Harbour	Hout Bay
Hout Bay Heights	Hout Bay
Imizamo Yethu	Hout Bay
Kenrock Country Estate	Hout Bay
Klein Leeukop Estate	Hout Bay
Kronenzicht	Hout Bay
Llandudno	Hout Bay
Mount Rhodes	Hout Bay
Northshore	Hout Bay
Oakwood Village Estate	Hout Bay
Penzance Estate	Hout Bay
Ruyteplaats Private Mountain Estate	Hout Bay
Scott Estate	Hout Bay
Stoney Brook	Hout Bay
Tierboskloof	Hout Bay
Tokai Forest Reserve	Hout Bay
Infanta	Infanta
Kontiki	Infanta
Gonnemanskraal	Jacobs Bay
Jacobs Bay	Jacobs Bay
Tooth Rock Estate	Jacobs Bay
Jongensfontein	Jongensfontein
Kalbaskraal	Kalbaskraal
Keurboomstrand	Keurboomstrand
Sanderlings Estate	Keurboomstrand
Twin Rivers Estate	Keurboomstrand
Bongweni	Khayelitsha
Ekuphumleni	Khayelitsha
Endlovini	Khayelitsha
Eyethu	Khayelitsha
Graceland	Khayelitsha
Griffiths Mxenge	Khayelitsha
Harare	Khayelitsha
Ikwezi Park	Khayelitsha
Ikwezipark	Khayelitsha
Ilitha Park	Khayelitsha
Khaya	Khayelitsha
Khayelitsha	Khayelitsha
Kuyasa	Khayelitsha
Mandela Park	Khayelitsha
Mfuleni	Khayelitsha
Monwabisi	Khayelitsha
Nonqubela	Khayelitsha
Silver Town	Khayelitsha
Solomon Mahlangu	Khayelitsha
Tembani	Khayelitsha
Town 2 Village 2A	Khayelitsha
Town 3 Village 2	Khayelitsha
Town 3 Village 3	Khayelitsha
Town 3 Village 4	Khayelitsha
Town 3 Village 5	Khayelitsha
Trevor Vilakazi	Khayelitsha
Victoria Mxenge	Khayelitsha
Washington Square	Khayelitsha
Klaarstroom	Klaarstroom
Bennetsville	Klapmuts
Klapmuts	Klapmuts
Klawer	Klawer
Klein Bay	Klein Bay
Kleinmond	Kleinmond
Klipdale	Klipdale
Belvidere Estate	Knysna
Blaricum Heights	Knysna
Bongani	Knysna
Concordia	Knysna
Concordia West	Knysna
Costa Sarda	Knysna
Dam se Bos	Knysna
Eastford	Knysna
Eastford Country Estate	Knysna
Eastford Downs	Knysna
Eastford Ridge	Knysna
Estuary Heights	Knysna
Etembini	Knysna
Fernwood Estate	Knysna
Fisherhaven	Knysna
Flenters	Knysna
Fraaisig	Knysna
Green Pastures	Knysna
Heuwelkruin	Knysna
Hornlee east	Knysna
Hornlee West	Knysna
Hunters Estate	Knysna
Hunters Home	Knysna
Hunters Village	Knysna
Jood se Kamp	Knysna
Kanonkop	Knysna
Khayaletu	Knysna
Knysna	Knysna
Knysna Central	Knysna
Knysna Heights	Knysna
Knysna Industrial	Knysna
Knysna Lifestyle Estate	Knysna
Leisure Isle	Knysna
Lelieskloof	Knysna
Narnia	Knysna
Nekkies	Knysna
Noetzie	Knysna
Old Place	Knysna
Ou Pad	Knysna
Paradise	Knysna
Pezula Private Estate	Knysna
Phantom River View Estate	Knysna
Qolweni	Knysna
Rexford	Knysna
Robololo	Knysna
Simola Golf and Country Estate	Knysna
Sparrebosch Clifftop Estate	Knysna
The Cove	Knysna
The Heads	Knysna
Thesens Island	Knysna
Water Ways	Knysna
Welbedacht	Knysna
Westford Bridge Estate	Knysna
Westhill	Knysna
White Location	Knysna
Karatara	Knysna Rural
Swartvlei	Knysna Rural
Bluewater Estate	Kommetjie
Imhofs Gift	Kommetjie
Klein Slangkop	Kommetjie
Klein Slangkop Private Estate	Kommetjie
Kommetjie	Kommetjie
Ocean View	Kommetjie
Outside	Kommetjie
Koringberg	Koringberg
Belmont Park	Kraaifontein
Bernadino Heights	Kraaifontein
Bloekombos	Kraaifontein
Bonnie Brae	Kraaifontein
Bonnie Brook	Kraaifontein
Buh-Rein Estate	Kraaifontein
Eikendal	Kraaifontein
Goliath Estate	Kraaifontein
Joostenberg Vlakte	Kraaifontein
Klein Begin	Kraaifontein
Kraaifontein	Kraaifontein
Kraaifontein East	Kraaifontein
Kraaifontein Industria	Kraaifontein
Langeberg Hoogte	Kraaifontein
Langeberg Ridge	Kraaifontein
Langeberg Smallholdings	Kraaifontein
Limber Lost Estate	Kraaifontein
Peerless Park East	Kraaifontein
Peerless Park North	Kraaifontein
Peerless Park West	Kraaifontein
Scottsdene	Kraaifontein
Scottsville	Kraaifontein
Stellenbosch Farms	Kraaifontein
Summerville	Kraaifontein
Tanglewood Estate	Kraaifontein
Viking Village	Kraaifontein
Wallace Dene	Kraaifontein
Windsor Park	Kraaifontein
Windsor Park Estate	Kraaifontein
Wynland Industrial Park	Kraaifontein
Zoo Park	Kraaifontein
Krantshoek	Krantshoek
Amandelrug	Kuils River
Amandelsig	Kuils River
Benno Park	Kuils River
Bosonia	Kuils River
Brandwag	Kuils River
Brantwood	Kuils River
Danarand	Kuils River
De Kuilen	Kuils River
Deo Gracia	Kuils River
Des Hampden	Kuils River
Drosdy Park	Kuils River
Eensgevonden	Kuils River
Eikenbosch	Kuils River
Eikenbosch Estate	Kuils River
Elim	Kuils River
Gersham	Kuils River
Haasendal	Kuils River
Highbury	Kuils River
Highbury Park	Kuils River
Hunters Creek	Kuils River
Hunters Retreat	Kuils River
Jacarandas	Kuils River
Jagtershof	Kuils River
Kalkfontein	Kuils River
Klein Zevenwacht Wine & Equestrian Estate	Kuils River
Klipdam	Kuils River
Kloofzicht	Kuils River
Kuils River	Kuils River
Kuils River Industrial	Kuils River
Kuils River South Small Holdings	Kuils River
Lillydale	Kuils River
Loucharmante	Kuils River
Mabille Park	Kuils River
Marinda Heights	Kuils River
Mikro Park	Kuils River
Oakdene	Kuils River
Penhill	Kuils River
Rouxville	Kuils River
Sarepta	Kuils River
Silveroaks	Kuils River
Soneike	Kuils River
Sonnekuil	Kuils River
St Dumas	Kuils River
Stellenbosch Farms	Kuils River
Stellendale Village	Kuils River
Turtle Creek	Kuils River
Voelvlei	Kuils River
Vredelust	Kuils River
Zevendal	Kuils River
Zevenwacht Country Estate	Kuils River
Zevenwacht Lifestyle Estate	Kuils River
Zevenwacht Wine Estate	Kuils River
Zevenzicht Residential Estate	Kuils River
Kurland	Kurland
Kwanokuthula	Kwanokuthula
Ladismith	Ladismith
Nissenville	Ladismith
Bergsig	Laingsburg
Goldnerville	Laingsburg
Laingsburg	Laingsburg
Lamberts Bay	Lamberts Bay
Malkopbaai	Lamberts Bay
Langa	Langa
Blue Lagoon	Langebaan
Calypso Beach	Langebaan
Country Club	Langebaan
La Pinta Lifestyle Village	Langebaan
Laguna Estate	Langebaan
Langebaan	Langebaan
Langebaan Country Estate	Langebaan
Leentjiesklip	Langebaan
Long Acres Country Estate	Langebaan
Myburgh Park	Langebaan
Mykonos	Langebaan
Olifantskop	Langebaan
Paradise Beach	Langebaan
Seaview Park	Langebaan
Skiathos	Langebaan
Sunset Estate	Langebaan
The Cove	Langebaan
Waterfront	Langebaan
Leeu Gamka	Leeu Gamka
Leipoldtville	Leipoldtville
Lutzville	Lutzville
Uitkyk	Lutzville
Acorn Creek Estate	Macassar
Croydon Olive Estate	Macassar
Croydon Vineyard Estate	Macassar
Faure	Macassar
Firgrove	Macassar
Kelderhof	Macassar
Kelderhof Country Village	Macassar
Macassar	Macassar
Sitari Country Estate	Macassar
Malagas	Malagas
Abbotsdale	Malmesbury
Doornkuil	Malmesbury
Greater Chatsworth	Malmesbury
Ilinge Lethu	Malmesbury
Malmesbury	Malmesbury
Mount Royal Golf & Country Estate	Malmesbury
Myrtledene	Malmesbury
Teen die Bult	Malmesbury
Wesbank	Malmesbury
Malmesbury Farms	Mamre
Mamre	Mamre
Matjiesfontein	Matjiesfontein
Airport Area	Matroosfontein
Bishop Lavis	Matroosfontein
Boquinar Industrial Area	Matroosfontein
Charlesville	Matroosfontein
Durheim	Matroosfontein
Kalksteenfontein	Matroosfontein
Matroosfontein	Matroosfontein
Montana	Matroosfontein
Montevideo	Matroosfontein
Nooitgedacht	Matroosfontein
Valhalla Park	Matroosfontein
Kliprand	Matzikama Rural
Koekenaap	Matzikama Rural
Olifants River Settlement	Matzikama Rural
Papendorp	Matzikama Rural
Mcgregor	McGregor
Atlantic Beach Golf Estate	Melkbosstrand
Duynefontein	Melkbosstrand
Melkbosstrand	Melkbosstrand
Van Riebeeckstrand	Melkbosstrand
Merweville	Merweville
Augusta	Milnerton
Bothasig	Milnerton
Burgundy Estate	Milnerton
Century City	Milnerton
Century Place	Milnerton
Century View	Milnerton
Coral Grove	Milnerton
Doornbach	Milnerton
Dunoon	Milnerton
Flamingo Vlei	Milnerton
Joe Slovo Park	Milnerton
Killarney Gardens	Milnerton
Marconi Beam	Milnerton
Milnerton	Milnerton
Milnerton Ridge	Milnerton
Montague Gardens	Milnerton
Oakhill	Milnerton
Parklands	Milnerton
Phoenix	Milnerton
Richmond Park	Milnerton
Richwood	Milnerton
Rivergate	Milnerton
Sanddrift	Milnerton
Summer Greens	Milnerton
Sunningdale	Milnerton
Sunridge	Milnerton
Sunset Beach	Milnerton
Sunset Links Golf Estate	Milnerton
Table View	Milnerton
Tijgerhof	Milnerton
Wentworth Village	Milnerton
West Riding	Milnerton
Westwood	Milnerton
Woodbridge Island	Milnerton
Bay View	Mitchells Plain
Beacon Valley	Mitchells Plain
Colorado	Mitchells Plain
Eastridge	Mitchells Plain
Heinz Park	Mitchells Plain
Highlands Village	Mitchells Plain
Hyde Park	Mitchells Plain
Lentegeur	Mitchells Plain
Mandalay	Mitchells Plain
Mitchells Plain Centre	Mitchells Plain
Morgans Village	Mitchells Plain
New Woodlands	Mitchells Plain
Portland	Mitchells Plain
Rocklands	Mitchells Plain
Rondevlei Park	Mitchells Plain
San Remo	Mitchells Plain
Strandfontein	Mitchells Plain
Strandfontein Village	Mitchells Plain
Tafelsig	Mitchells Plain
Wavecrest	Mitchells Plain
Weltevreden Valley	Mitchells Plain
Westgate	Mitchells Plain
Westridge	Mitchells Plain
Wildwood	Mitchells Plain
Wolfgat Nature Reserve	Mitchells Plain
Woodlands	Mitchells Plain
Ashbury	Montagu
Bergsig	Montagu
Mandela Square	Montagu
Montagu	Montagu
Bergsig	Moorreesburg
Bothasig	Moorreesburg
Doornkloof	Moorreesburg
Moorreesburg	Moorreesburg
Rosenhof	Moorreesburg
Steynsburg	Moorreesburg
Alma Park	Mossel Bay
Bay View	Mossel Bay
Blue Ridge	Mossel Bay
Boplaas	Mossel Bay
D' Almeida	Mossel Bay
Dana Bay	Mossel Bay
De Nova	Mossel Bay
Die Bakke	Mossel Bay
Die Voor Bay	Mossel Bay
Fairview	Mossel Bay
Fishermans Village	Mossel Bay
Fynbos Heights	Mossel Bay
Hartenbos	Mossel Bay
Heiderand	Mossel Bay
Heiderand Extension	Mossel Bay
Isazane	Mossel Bay
Isinyoka	Mossel Bay
Kwanonqaba	Mossel Bay
Kwanonqaba Ext	Mossel Bay
Linkside	Mossel Bay
Monte Christo Retirement Village	Mossel Bay
Moquini Coastal Estate	Mossel Bay
Mossdustria	Mossel Bay
Mossel Bay	Mossel Bay
Mossel Bay Central	Mossel Bay
Mossel Bay Golf Estate	Mossel Bay
Mossel Bay Remainder	Mossel Bay
Num-Num Estate	Mossel Bay
Paradise Coast Beach and Eco Estate	Mossel Bay
Pinnacle Point	Mossel Bay
Santos Bay	Mossel Bay
Tuscany Park	Mossel Bay
Twee Kuilen	Mossel Bay
Village On Sea	Mossel Bay
Vyf Brakke Fonteinen	Mossel Bay
Nautilus Bay	Mossel Bay Rural
Springerbaai Coastal Eco Estate	Mossel Bay Rural
Capricorn	Muizenberg
Costa Da Gama	Muizenberg
Fishermans Village	Muizenberg
Lakeside	Muizenberg
Marina Da Gama	Muizenberg
Muizenberg	Muizenberg
Muizenberg Mountains	Muizenberg
Soralia Village	Muizenberg
Southbreak	Muizenberg
St James	Muizenberg
Stonehurst Mountain Estate	Muizenberg
Vrygrond	Muizenberg
Murraysburg	Murraysburg
Napier	Napier
Tamatekraal	Napier
Nature's Valley	Nature's Valley
Nelspoort	Nelspoort
Belvedere	Noordhoek
Cape Point Vineyards Estate	Noordhoek
Chapman's Bay Estate	Noordhoek
Chapmans Peak	Noordhoek
Chapmans Peak Estate	Noordhoek
Crofters Valley	Noordhoek
De Goede Hoop Estate	Noordhoek
Lake Michelle	Noordhoek
Noordhaven	Noordhoek
Noordhoek	Noordhoek
Noordhoek Manor	Noordhoek
San Michel	Noordhoek
Silver Mine Village	Noordhoek
Nuwerus	Nuwerus
Nyanga	Nyanga
Chanteclair	Onrus
Onrus River	Onrus
Bongolethu	Oudtshoorn
Bridgeton	Oudtshoorn
Netton	Oudtshoorn
Oudtshoorn	Oudtshoorn
Toekomsrus	Oudtshoorn
Armoed	Oudtshoorn Rural
De Hoop	Oudtshoorn Rural
Arabella Country Estate	Overstrand Rural
Baardscheerders Bosch	Overstrand Rural
Benguela Cove Lagoon Wine Estate	Overstrand Rural
Meerenbosch	Overstrand Rural
Sandown Bay	Overstrand Rural
Viljoenshof	Overstrand Rural
Amstelhof	Paarl
Bergenzicht Country Estate	Paarl
Boschenmeer Golf Estate	Paarl
Charleston Hill	Paarl
Chicago	Paarl
Courtrai	Paarl
D`Grande Vredenburg	Paarl
Dal Josafat Industrial	Paarl
Dalvale	Paarl
De Zoete Inval	Paarl
Denneburg	Paarl
Groenheuwel	Paarl
Groenleegte	Paarl
Groenvlei	Paarl
Hugenot	Paarl
Klein Nederburg	Paarl
Klein Parys	Paarl
Langvlei	Paarl
Lantana	Paarl
Lemoenkloof	Paarl
Mbekweni	Paarl
Milky Town	Paarl
Mountain	Paarl
New Orleans	Paarl
New York	Paarl
Northern Paarl	Paarl
Paarl	Paarl
Paarl Central East	Paarl
Paarl Central West	Paarl
Paryskloof Estate	Paarl
Riverside	Paarl
Smartie Town	Paarl
Southern Paarl	Paarl
Vrykyk	Paarl
Avondale	Parow
Baronetcy Estate	Parow
Beaconvale	Parow
Belvedere	Parow
Churchill Estate	Parow
Clamhall	Parow
De Duin	Parow
De Grendel	Parow
De Tijger	Parow
Fairfield Estate	Parow
Florida	Parow
Fontaine Bleau	Parow
Glenlily	Parow
Goedgedacht	Parow
Kaapzicht	Parow
Kleinbosch	Parow
Klipkop	Parow
La Vie Private Estate	Parow
Leopard Rock Estate	Parow
Little Rock Villas	Parow
Modderdam	Parow
Northgate	Parow
Oostersee	Parow
Panorama	Parow
Parow	Parow
Parow East	Parow
Parow Industrial	Parow
Parow North	Parow
Parow Valley	Parow
Plattekloof 1	Parow
Plattekloof 2	Parow
Plattekloof 3	Parow
Plattekloof 4	Parow
Ravensmead	Parow
Sonnendal	Parow
Tygerberg Hospital	Parow
Uitsig	Parow
Villa Caponera Estate	Parow
Welgelegen 1	Parow
Welgelegen 2	Parow
Welgelegen 3	Parow
Bek Bay	Paternoster
Kliprug	Paternoster
Mosselbank	Paternoster
Paternoster	Paternoster
Pelgrimsrust	Paternoster
Voorstrand	Paternoster
Pearly Beach	Pearly Beach
Philadelphia	Philadelphia
Browns Farms	Philippi
Highlands Estate	Philippi
Knole Park	Philippi
Philippi	Philippi
Philippi Park	Philippi
Weltevreden Valley North	Philippi
Piketberg	Piketberg
Wheatfields	Piketberg
Bossies Gif	Plettenberg Bay
Brackenridge Private Residential Estate	Plettenberg Bay
Goose Valley Golf Estate	Plettenberg Bay
New Horizons	Plettenberg Bay
Plettenberg Bay	Plettenberg Bay
Robberg Ridge	Plettenberg Bay
Schoongezicht Country Estate	Plettenberg Bay
The Hill Private Estate	Plettenberg Bay
Turtle Creek Golf Estate	Plettenberg Bay
Weldon	Plettenberg Bay
Whale Rock	Plettenberg Bay
Whale Rock Beach	Plettenberg Bay
Whale Rock Heights	Plettenberg Bay
Whale Rock Hill	Plettenberg Bay
Whale Rock Resort	Plettenberg Bay
Whale Rock Ridge	Plettenberg Bay
Whale Rock Verde	Plettenberg Bay
Pniel	Pniel
Monte Bertha	Porterville
Porterville	Porterville
North End	Prince Albert
Prince Albert	Prince Albert
Prince Alfred Hamlet	Prince Alfred Hamlet
Pringle Bay	Pringle Bay
Rawsonville	Rawsonville
Redelinghuys	Redelinghuys
Rheenendal	Rheenendal
Esterhof	Riebeek Kasteel
Riebeek Kasteel	Riebeek Kasteel
Riebeek West	Riebeek West
Rietpoort	Rietpoort
Garcia	Riversdale
Riversdale	Riversdale
Riversdale Settlement	Riversdale
Riviersonderend	Riviersonderend
Robben Island	Robben Island
Dorpsig	Robertson
Dro??heuwel	Robertson
M??reson	Robertson
Nkqubela	Robertson
Panorama	Robertson
Robertson	Robertson
Silwerstrand Golf and River Estate	Robertson
Rooi-Els	Rooi-Els
Blouwater Bay	Saldanha
Diazville	Saldanha
Hoogland	Saldanha
Military	Saldanha
Parkersdorp	Saldanha
Saldanha	Saldanha
Saldanha Harbour	Saldanha
Saldanha Industrial Development Zone	Saldanha
White City	Saldanha
Langebaanweg	Saldanha Bay Rural
Leisure Park	Sand Bay
Ocean Breeze	Sand Bay
Protea Park	Sand Bay
Sand Bay	Sand Bay
Sundew Villas	Sand Bay
Tambali Village	Sand Bay
The Avenues	Sand Bay
Saron	Saron
Misty Cliffs	Scarborough
Scarborough	Scarborough
Cola Beach	Sedgefield
Groenvallei	Sedgefield
Meedingsride	Sedgefield
Montmere	Sedgefield
Myoli Beach	Sedgefield
Sedgefield	Sedgefield
Sedgefield Island	Sedgefield
Sizamile	Sedgefield
Smutsville	Sedgefield
The Island Village	Sedgefield
Zeegezicht	Sedgefield
Admirals Kloof	Simon's Town
Bay View Village	Simon's Town
Bayview Heights	Simon's Town
Bellvue	Simon's Town
Boulders	Simon's Town
Da Gama Park	Simon's Town
Dido Valley	Simon's Town
Farm 964	Simon's Town
Froggy Farm	Simon's Town
Glen Marine	Simon's Town
Glen Ridge	Simon's Town
Glencairn	Simon's Town
Glencairn Heights	Simon's Town
Harbour Heights	Simon's Town
Mount Pleasant	Simon's Town
Murdock Valley	Simon's Town
Pine Haven	Simon's Town
Seaforth	Simon's Town
Simons Kloof	Simon's Town
Simon's Town	Simon's Town
Welcome Glen	Simon's Town
Winford	Simon's Town
Woodlands	Simon's Town
High Riding Country Estate	Sir Lowrys Pass
Sir Lowrys Pass	Sir Lowrys Pass
Somerset Forest	Sir Lowrys Pass
Sun City	Sir Lowrys Pass
Tre Donne	Sir Lowrys Pass
Slangrivier	Slangrivier
77 on Drummer	Somerset West
Audas Estate	Somerset West
Bel' Aire Winelands Estate	Somerset West
Bene	Somerset West
Bergalo	Somerset West
Blue Crane Estate	Somerset West
Boskloof Eco Estate	Somerset West
Braeview	Somerset West
Bridgebank	Somerset West
Bridgewater	Somerset West
Briza	Somerset West
Brookside Village	Somerset West
Carey Parks	Somerset West
Carwick	Somerset West
Castle Rising Estate	Somerset West
Cherrywood Gardens	Somerset West
Chris Nissen Park	Somerset West
Dennegeur	Somerset West
Die Wingerd	Somerset West
Dorhill	Somerset West
Erinvale Estate	Somerset West
Fairhaven Country Estate	Somerset West
Fairview Heights	Somerset West
Fernwood Estate	Somerset West
Fraaigelegen	Somerset West
Garden Village	Somerset West
Goede Hoop	Somerset West
Golden Acre	Somerset West
Golden Hill	Somerset West
Greenway Rise	Somerset West
Griselda	Somerset West
Hageland	Somerset West
Helderberg Estate	Somerset West
Helderberg Nature Reserve	Somerset West
Helderberg Village	Somerset West
Helderrand	Somerset West
Heldervue	Somerset West
Helderzicht	Somerset West
Helena Heights	Somerset West
Heritage Mews	Somerset West
Heritage Park	Somerset West
Highveld	Somerset West
Humanshof	Somerset West
Illaire	Somerset West
Jacques Hill	Somerset West
Jonkers Hoogte	Somerset West
Kalamunda	Somerset West
La Concorde	Somerset West
La Montagne	Somerset West
La Piazza	Somerset West
La Sandra	Somerset West
Land En Zeezicht	Somerset West
Lionviham	Somerset West
Longdown Estate	Somerset West
Lourens River Estate	Somerset West
Lynn's View	Somerset West
Martinville	Somerset West
Meerhof Estate	Somerset West
Montchere	Somerset West
Monte Sereno	Somerset West
Morningside	Somerset West
Natures Valley	Somerset West
Nutwood	Somerset West
Nutwood Gardens Estate	Somerset West
Olijvenhof Estate	Somerset West
Olive Grove	Somerset West
Paardevlei	Somerset West
Parel Vallei	Somerset West
Pearl Marina	Somerset West
Pearl Rise	Somerset West
Radloff Park	Somerset West
Rome Glen	Somerset West
Roundhay	Somerset West
Schapenberg Estate	Somerset West
Schonenberg Estate	Somerset West
Sea View Lake	Somerset West
Shady Glen	Somerset West
Silver Fox Estate	Somerset West
Silvertas	Somerset West
Somerset Country Estate	Somerset West
Somerset Heights	Somerset West
Somerset Lakes	Somerset West
Somerset Ridge	Somerset West
Somerset West	Somerset West
Somerset West Business Park	Somerset West
Somerset West Country Club	Somerset West
Spanish Farm	Somerset West
Steenbras View	Somerset West
Steyn's Nest	Somerset West
Stuart's Hill	Somerset West
The Link	Somerset West
The Vines	Somerset West
Vergezicht Estate	Somerset West
Victoria Park	Somerset West
Vredenberg Estate	Somerset West
Vredenzicht Estate	Somerset West
Westridge	Somerset West
Zandberg	Somerset West
Blueberry Hill	St Helena Bay
Brandhuis	St Helena Bay
Britannia Bay	St Helena Bay
Britannica Heights	St Helena Bay
Columbine	St Helena Bay
Duyker Eiland	St Helena Bay
Golden Mile	St Helena Bay
Hannas Bay	St Helena Bay
Harbour Lights	St Helena Bay
Klein Koornhuis	St Helena Bay
Laingville	St Helena Bay
Lampiesbaai	St Helena Bay
Midwest	St Helena Bay
Sandy Point	St Helena Bay
Sandy Point Beach Estate	St Helena Bay
Shelley Point	St Helena Bay
Steenberg's Cove	St Helena Bay
Stompneus Bay	St Helena Bay
Stompneus Village	St Helena Bay
West Point	St Helena Bay
Stanford	Stanford
Sunrise Village	Stanford
Aanhou Wen	Stellenbosch
Anesta	Stellenbosch
Arbeidslus	Stellenbosch
Bo Dalsig	Stellenbosch
Brandwacht	Stellenbosch
Brandwacht aan Rivier	Stellenbosch
Cloetesville	Stellenbosch
Dalsig	Stellenbosch
De Bosch Estate	Stellenbosch
De Zalze Golf Estate	Stellenbosch
Devon Park	Stellenbosch
Devonvallei	Stellenbosch
Die Boord	Stellenbosch
Die Rand	Stellenbosch
Die Wingerd	Stellenbosch
Dr Malan	Stellenbosch
Eden	Stellenbosch
Fairways	Stellenbosch
Harringtons Place	Stellenbosch
Idasvallei	Stellenbosch
Jamestown	Stellenbosch
Karindal	Stellenbosch
Kaya Mandi	Stellenbosch
Kleingeluk	Stellenbosch
Kleinvallei	Stellenbosch
Kromrivier	Stellenbosch
La Colline	Stellenbosch
La Pastorale	Stellenbosch
Lieberheim	Stellenbosch
Lindida	Stellenbosch
Mostertsdrift	Stellenbosch
Mt Simon Estate	Stellenbosch
Onder Papegaaiberg	Stellenbosch
Paradyskloof	Stellenbosch
Plankenbrug	Stellenbosch
Rozendal	Stellenbosch
Schuilplaats	Stellenbosch
Simonswyk	Stellenbosch
Stellenbosch	Stellenbosch
Stellenbosch Central	Stellenbosch
Stellenbosch NU	Stellenbosch
Tegno Park	Stellenbosch
Tennantville	Stellenbosch
Tweespruit Estate	Stellenbosch
Uniepark	Stellenbosch
Universiteits Oord	Stellenbosch
Welgelegen	Stellenbosch
Welgevonden Estate	Stellenbosch
Weltevrede	Stellenbosch
Stellenbosch Farms	Stellenbosch Farms
De Hollandsche	Stellenbosch Rural
Deltacrest	Stellenbosch Rural
Devonvale Golf & Wine Estate	Stellenbosch Rural
Digteby Estate	Stellenbosch Rural
Elsenburg	Stellenbosch Rural
Koelenhof	Stellenbosch Rural
Koelpark	Stellenbosch Rural
Kylemore	Stellenbosch Rural
La Motte	Stellenbosch Rural
Lanquedoc	Stellenbosch Rural
Longlands Country Estate	Stellenbosch Rural
Lyndoch	Stellenbosch Rural
Raithby	Stellenbosch Rural
Robertsvlei	Stellenbosch Rural
Slaley Estate	Stellenbosch Rural
Wemmershoek	Stellenbosch Rural
Melkhoutfontein	Still Bay
Stilbaai Duine	Still Bay
Still Bay East	Still Bay
Still Bay West	Still Bay
Asanda	Strand
Broadlands	Strand
Broadlands Industrial Park	Strand
Broadlands Village	Strand
Die Bos	Strand
Gants Plaza	Strand
George Park	Strand
Goede Hoop	Strand
Greenways Golf Estate	Strand
Guldenland	Strand
Gustrow	Strand
Helderberg Park	Strand
Langewacht	Strand
Lochnerhof	Strand
Longlands	Strand
Lwandle	Strand
Nomzamo	Strand
Onverwacht	Strand
Rome	Strand
Rusthof	Strand
Sercor Park	Strand
Somerset Park	Strand
Southfork	Strand
Strand	Strand
Strandvale	Strand
Tarentaal Farm	Strand
The Palms	Strand
Van Der Stel	Strand
Van Ryneveld	Strand
Weltevreden	Strand
Winston Estate	Strand
Louis Rood	Strandfontein
Strandfontein	Strandfontein
Argonauta	Struis Bay
Molshoop	Struis Bay
Struis Bay	Struis Bay
Suiderstrand	Suiderstrand
Rietkuil SH	Suurbraak
Suurbraak	Suurbraak
Klipfontyn	Swartland Rural
Malmesbury Farms	Swartland Rural
Riebeek West Mine	Swartland Rural
Hermitage	Swellendam
Railton	Swellendam
Swellendam	Swellendam
Cranefields Waterfront Estate	Theewaterskloof
Dennehof	Theewaterskloof
Gloria Bay	Theewaterskloof
Theewaterskloof Country Estate	Theewaterskloof
Maremmana	Theewaterskloof Rural
Mount Eland Township	Theewaterskloof Rural
Tesselaarsdal	Theewaterskloof Rural
Touws River	Touws River
Meulstroom	Tulbagh
Tulbagh	Tulbagh
Witzenville	Tulbagh
Tulbagh Road	Tulbagh Road
Lyonville	Uniondale
Uniondale	Uniondale
Maskamsig	Vanrhynsdorp
Vanrhynsdorp	Vanrhynsdorp
Vanwyksdorp	Vanwyksdorp
Admiral Island and Port Owen Estates	Velddrif
Atlantic Sands	Velddrif
Atlantic Shores	Velddrif
Atlantic Waves	Velddrif
Dwarskersbos	Velddrif
Laaiplek	Velddrif
Noordhoek	Velddrif
Velddrif	Velddrif
Vermont	Vermont
Victoria Bay	Victoria Bay
Goniwe Park	Villiersdorp
Nuwedorp B	Villiersdorp
Villiersdorp	Villiersdorp
Villiersdorp Mountain Estate	Villiersdorp
Vlees Bay	Vlees Bay
Louwville	Vredenburg
Marais Industria	Vredenburg
Ongegund	Vredenburg
Rusfontein	Vredenburg
Tierkloof	Vredenburg
Vredenburg	Vredenburg
Witteklip	Vredenburg
Aiville Park	Vredendal
Joe Slovo Park	Vredendal
Vredendal	Vredendal
Welgemoed	Welgemoed
Bainsvallei	Wellington
Berg en Dal	Wellington
Hillcrest	Wellington
Newtown	Wellington
Onverwacht Wine Estate	Wellington
The Diemersfontein Village	Wellington
Van Wyks Vlei	Wellington
Volendam	Wellington
Wellington	Wellington
Wellington Central	Wellington
Wellington East	Wellington
Wellington North	Wellington
Hoekwil	Wilderness
Kleinkrantz	Wilderness
Wilderness	Wilderness
Wilderness Garden Estate	Wilderness
Wilderness Heights	Wilderness
Breedezicht Estate	Witsand
Witsand	Witsand
Wittedrift	Wittedrift
Montana	Wolseley
Pine Valley	Wolseley
Wolseley	Wolseley
Avian Park	Worcester
Bergsig	Worcester
Esselen Park	Worcester
Fairy Glen	Worcester
Florian Park	Worcester
Hexpark	Worcester
Hospital Hill	Worcester
Hospital Park	Worcester
Johnsons Park	Worcester
Langerug	Worcester
Mandela Square	Worcester
Meirings Park	Worcester
Noble Park	Worcester
Paglande	Worcester
Panorama	Worcester
Parkersdam	Worcester
Reunion Park	Worcester
Riverview	Worcester
Roodewal	Worcester
Roux Park	Worcester
Somerset Park	Worcester
Van Riebeeck Park	Worcester
Victoria Park	Worcester
Worcester	Worcester
Worcester Central	Worcester
Worcester Industrial	Worcester
Worcester NU	Worcester
Worcester West	Worcester
Zweletemba	Worcester
Wuppertal	Wupperthal
Mile 16 Private Beach Estate	Yzerfontein
Pearl Bay	Yzerfontein
Yzerfontein	Yzerfontein
Droevlei	Zoar
Protea Park	Zoar
Zoar	Zoar
